24
282.857 488.571 51.4286 51.4286
282.857 385.714 51.4286 51.4286
282.857 282.857 51.4286 51.4286
540 385.714 51.4286 51.4286
694.286 385.714 51.4286 51.4286
540 488.571 51.4286 51.4286
694.286 488.571 51.4286 51.4286
900 488.571 51.4286 51.4286
900 385.714 51.4286 51.4286
900 282.857 51.4286 51.4286
797.143 180 51.4286 51.4286
437.143 180 51.4286 51.4286
540 180 51.4286 51.4286
694.286 180 51.4286 51.4286
694.286 591.429 51.4286 51.4286
900 591.429 51.4286 51.4286
77.1429 540 51.4286 51.4286
77.1429 437.143 51.4286 51.4286
77.1429 334.286 51.4286 51.4286
77.1429 231.429 51.4286 51.4286
77.1429 128.571 51.4286 51.4286
282.857 180 51.4286 51.4286
282.857 77.1429 51.4286 51.4286
540 591.429 51.4286 51.4286
14 20
0 0   0 0   2 0   1 0   2 180   0 0   0 0   0 0   0 0   0 0   0 0   0 0   0 0   0 0   0 0   0 0   0 0   0 0   0 0   0 0   
0 0   0 0   2 0   1 0   2 180   0 0   0 0   0 0   0 0   0 0   0 0   0 0   0 0   0 0   0 0   0 0   0 0   0 0   0 0   0 0   
0 0   0 0   2 0   1 0   2 180   0 0   0 0   0 0   0 0   0 0   0 0   0 0   0 0   0 0   0 0   0 0   0 0   0 0   0 0   0 0   
0 0   0 0   2 0   1 0   2 180   0 0   0 0   0 0   0 0   0 0   0 0   0 0   0 0   0 0   0 0   0 0   0 0   0 0   0 0   0 0   
0 0   0 0   2 0   1 0   2 180   0 0   0 0   6 180   2 90   2 90   2 90   2 90   2 90   2 90   2 90   2 90   6 270   0 0   0 0   0 0   
0 0   0 0   2 0   1 0   2 180   0 0   0 0   2 0   1 180   1 0   1 0   1 0   1 0   1 0   1 0   1 0   2 180   0 0   0 0   0 0   
0 0   0 0   2 0   1 0   2 180   0 0   0 0   2 0   1 0   3 90   2 270   2 270   2 270   2 270   3 180   1 0   2 180   0 0   0 0   0 0   
0 0   0 0   2 0   1 0   2 180   0 0   0 0   2 0   1 0   2 180   0 0   0 0   0 0   0 0   2 0   1 0   2 180   0 0   0 0   0 0   
0 0   0 0   2 0   1 0   2 180   0 0   0 0   2 0   1 0   2 180   0 0   0 0   0 0   0 0   2 0   1 0   2 180   0 0   0 0   0 0   
0 0   0 0   2 0   1 0   2 180   0 0   0 0   2 0   1 0   2 180   0 0   0 0   0 0   0 0   2 0   1 0   2 180   0 0   0 0   0 0   
0 0   0 0   2 0   1 0   3 0   2 90   2 90   3 270   1 0   2 180   0 0   0 0   0 0   0 0   2 0   1 0   2 180   0 0   0 0   0 0   
0 0   0 0   2 0   1 0   1 0   1 0   1 0   1 0   1 0   2 180   0 0   0 0   0 0   0 0   2 0   1 0   2 180   0 0   0 0   0 0   
0 0   0 0   6 90   2 270   2 270   2 270   2 270   2 270   2 270   6 0   0 0   0 0   0 0   0 0   2 0   1 0   2 180   0 0   0 0   0 0   
0 0   0 0   0 0   0 0   0 0   0 0   0 0   0 0   0 0   0 0   0 0   0 0   0 0   0 0   2 0   1 0   2 180   0 0   0 0   0 0   
6
180 25.7143
180 591.429
437.143 591.429
437.143 282.857
797.143 282.857
797.143 694.286
End
