28
77 77 51.4286 51.4286
77 180 51.4286 51.4286
77 282 51.4286 51.4286
77 385 51.4286 51.4286
77 488 51.4286 51.4286
77 591 51.4286 51.4286
180 694 51.4286 51.4286
282 694 51.4286 51.4286
385 694 51.4286 51.4286
334 488 51.4286 51.4286
282 385 51.4286 51.4286
334 282 51.4286 51.4286
282 180 51.4286 51.4286
437 180 51.4286 51.4286
540 180 51.4286 51.4286
797 180 51.4286 51.4286
694 180 51.4286 51.4286
900 282 51.4286 51.4286
900 385 51.4286 51.4286
900 488 51.4286 51.4286
900 591 51.4286 51.4286
694 591 51.4286 51.4286
694 488 51.4286 51.4286
694 385 51.4286 51.4286
540 385 51.4286 51.4286
540 488 51.4286 51.4286
540 591 51.4286 51.4286
282 77 51.4286 51.4286
14 20
0 0   0 0   2 0   1 0   2 180   0 0   0 0   0 0   0 0   0 0   0 0   0 0   0 0   0 0   0 0   0 0   0 0   0 0   0 0   0 0   
0 0   0 0   2 0   1 0   2 180   0 0   0 0   0 0   0 0   0 0   0 0   0 0   0 0   0 0   0 0   0 0   0 0   0 0   0 0   0 0   
0 0   0 0   2 0   1 0   2 180   0 0   0 0   0 0   0 0   0 0   0 0   0 0   0 0   0 0   0 0   0 0   0 0   0 0   0 0   0 0   
0 0   0 0   2 0   1 0   2 180   0 0   0 0   0 0   0 0   0 0   0 0   0 0   0 0   0 0   0 0   0 0   0 0   0 0   0 0   0 0   
0 0   0 0   2 0   1 0   2 180   0 0   0 0   6 180   2 90   2 90   2 90   2 90   2 90   2 90   2 90   2 90   6 270   0 0   0 0   0 0   
0 0   0 0   2 0   1 0   2 180   0 0   0 0   2 0   1 180   1 0   1 0   1 0   1 0   1 0   1 0   1 0   2 180   0 0   0 0   0 0   
0 0   0 0   2 0   1 0   2 180   0 0   0 0   2 0   1 0   3 90   2 270   2 270   2 270   2 270   3 180   1 0   2 180   0 0   0 0   0 0   
0 0   0 0   2 0   1 0   2 180   0 0   0 0   2 0   1 0   2 180   0 0   0 0   0 0   0 0   2 0   1 0   2 180   0 0   0 0   0 0   
0 0   0 0   2 0   1 0   2 180   0 0   0 0   2 0   1 0   2 180   0 0   0 0   0 0   0 0   2 0   1 0   2 180   0 0   0 0   0 0   
0 0   0 0   2 0   1 0   2 180   0 0   0 0   2 0   1 0   2 180   0 0   0 0   0 0   0 0   2 0   1 0   2 180   0 0   0 0   0 0   
0 0   0 0   2 0   1 0   3 0   2 90   2 90   3 270   1 0   2 180   0 0   0 0   0 0   0 0   2 0   1 0   2 180   0 0   0 0   0 0   
0 0   0 0   2 0   1 0   1 0   1 0   1 0   1 0   1 0   2 180   0 0   0 0   0 0   0 0   2 0   1 0   2 180   0 0   0 0   0 0   
0 0   0 0   6 90   2 270   2 270   2 270   2 270   2 270   2 270   6 0   0 0   0 0   0 0   0 0   2 0   1 0   2 180   0 0   0 0   0 0   
0 0   0 0   0 0   0 0   0 0   0 0   0 0   0 0   0 0   0 0   0 0   0 0   0 0   0 0   2 0   1 0   2 180   0 0   0 0   0 0   
6
180 25
180 591
437 591
437 282
797 282
797 694
End
